suas sql para usar no GRUD as colunas=

SELECT "ID_Empresas", "RazaoSocial", "NomeFantasia", "CNPJ", "Endereco", "EndNumero", "EndBairro", "EndComplemento", "EndCEP", "EndCidade", "EndEstado", "EndPais", "EmpTel1", "EmpTel2", "EmpEmail", "PaginaWeb", "IE", "IM", "NaturezaJuridica", "EmpInicioAtividade", "EmpCriado", "Processo", "Status", "NIRE", "CNAEPrincipal", "CNAESecundario", "RamoDeAtividade", "ResponsavelCPF", "ResponsavelNome", "ProtocoloJuntaComercial", "Geral", "Lembrete", "ProtocoloREDESIM", "DataProtREDESIM", "DataProtJuntaComercial", "DataPedidoIE", "AvisarDia", "PrazoSimples", "NireAlt", "JuntaObs", "NRegistroAlt", "DataRegistroAlt", "NireAntigos", "NAlteracao", "RedeSimObs", "EstadualObs", "PrefeituraObs", "CodigoSimples", "CPFResponsavel", "NomeResponsavel", "ArquivoContrato", "Procedimento", "Prioridade", "RegimeFederal", "PorteDaEmpresa", "TipoDeEmpresa", "AltConsolidada", "Motivo", "DataMotivo", "IEComprovante", "IEInicioAtividade", "IEVencPedido", "BombeiroJunta", "IEjunta", "ProtJuntaFinal", "Tituloeleitor", area, area2, "ObsSimples", "DataSimples", "DataUltdefSimples", "OrgãoPedSimples", "PastaDocumentos", "RespRG", "Historico", "AltProt", "CapitalS", "CapitalI", "DataExcSocial", "CNHnumero", "CNHexp", "CNHdataexp", "RespMae", "RespDataNasc", "CadImob", "EndZona", "EndQuadra", "EndData", "RespRgSigla", "Procuracao", "ProcuracaoN", "ProcuracaoData", "NovaRazaoSocial1", "NovaRazaoSocial2", "NovaRazaoSocial3", "NovaRazaoSocial", "Eventos", "SenhaGov", "RespPai", "NIRERegistro", "NIRERegistroData", "NovaRazaoSocialFinal", "IEOnline", "IETipo", "IEeProcNum", "IEDataAltSolicitado", "SistemaExterno", "NireData", "DadosSocios", "QuantidadeSocios", "DocContratos", "RazaoSocialAntiga", "SituacaoCadastral", "DivisaoCapitalSocios", "CapitalQuotaValor", "CapitaQuotaTotal", "CPFdoCONJUGE", "NOMEdoCONJUGE", "ResponsavelOrgaoRG", "ResponsavelEstadoOrgaoRG", "NumeroProcesso", "ReciboProcesso", "SEDE", "PontoDeReferencia", "TipoUnidadeProdutiva", "FormaDeAtuacao", "DadosComplEstabelecimento", "DadosComplAtividade", "DadosComplPavimentos", "DadosComplPessoas", "DadosComplSubsolo", "DadosComplLiquido", "DadosComplGLP", "AjudaTipodeUnidade", "DBEProtocolo", "DBEData", "FederalProtocolo", "SenhasDeAcesso", "CapitalSocialAntigo", "CapitalAntigoMudou", "CNAEAtividadeNoLocal", "CNAEAtvLocalPrincipal", "CNAEAtvLocalSEcundarios", "BombeiroAtvAdm", "BombeiroAtvresidencia", "CNAEdescricaoOficial", "ObjetoDOEstabelecimento", "SimplesEcac", "AvisarEmpresa", "AvisarEmpresaTexto", "TemEnderecoAntigoEmp", "EnderecoAntigoEmp", "CodSistemaExterno"
FROM public."Empresas";

"ID_Empresas"	"smallint"
"RazaoSocial"	"text"
"NomeFantasia"	"text"
"CNPJ"	"text"
"Endereco"	"text"
"EndNumero"	"text"
"EndBairro"	"text"
"EndComplemento"	"text"
"EndCEP"	"text"
"EndCidade"	"text"
"EndEstado"	"text"
"EndPais"	"text"
"EmpTel1"	"text"
"EmpTel2"	"text"
"EmpEmail"	"text"
"PaginaWeb"	"text"
"IE"	"text"
"IM"	"text"
"NaturezaJuridica"	"text"
"EmpInicioAtividade"	"timestamp with time zone"
"EmpCriado"	"timestamp with time zone"
"Processo"	"text"
"Status"	"text"
"NIRE"	"text"
"CNAEPrincipal"	"text"
"CNAESecundario"	"text"
"RamoDeAtividade"	"text"
"ResponsavelCPF"	"text"
"ResponsavelNome"	"text"
"ProtocoloJuntaComercial"	"text"
"Geral"	"text"
"Lembrete"	"boolean"
"ProtocoloREDESIM"	"text"
"DataProtREDESIM"	"timestamp with time zone"
"DataProtJuntaComercial"	"timestamp with time zone"
"DataPedidoIE"	"timestamp with time zone"
"AvisarDia"	"timestamp with time zone"
"PrazoSimples"	"timestamp with time zone"
"NireAlt"	"text"
"JuntaObs"	"text"
"NRegistroAlt"	"text"
"DataRegistroAlt"	"timestamp with time zone"
"NireAntigos"	"text"
"NAlteracao"	"text"
"RedeSimObs"	"text"
"EstadualObs"	"text"
"PrefeituraObs"	"text"
"CodigoSimples"	"text"
"CPFResponsavel"	"text"
"NomeResponsavel"	"text"
"ArquivoContrato"	"text"
"Procedimento"	"text"
"Prioridade"	"boolean"
"RegimeFederal"	"text"
"PorteDaEmpresa"	"text"
"TipoDeEmpresa"	"text"
"AltConsolidada"	"text"
"Motivo"	"text"
"DataMotivo"	"timestamp with time zone"
"IEComprovante"	"text"
"IEInicioAtividade"	"timestamp with time zone"
"IEVencPedido"	"timestamp with time zone"
"BombeiroJunta"	"text"
"IEjunta"	"text"
"ProtJuntaFinal"	"timestamp with time zone"
"Tituloeleitor"	"text"
"area"	"text"
"area2"	"text"
"ObsSimples"	"text"
"DataSimples"	"timestamp with time zone"
"DataUltdefSimples"	"timestamp with time zone"
"OrgãoPedSimples"	"text"
"PastaDocumentos"	"text"
"RespRG"	"text"
"Historico"	"text"
"AltProt"	"text"
"CapitalS"	"text"
"CapitalI"	"text"
"DataExcSocial"	"timestamp with time zone"
"CNHnumero"	"text"
"CNHexp"	"text"
"CNHdataexp"	"timestamp with time zone"
"RespMae"	"text"
"RespDataNasc"	"timestamp with time zone"
"CadImob"	"text"
"EndZona"	"text"
"EndQuadra"	"text"
"EndData"	"timestamp with time zone"
"RespRgSigla"	"text"
"Procuracao"	"text"
"ProcuracaoN"	"text"
"ProcuracaoData"	"timestamp with time zone"
"NovaRazaoSocial1"	"text"
"NovaRazaoSocial2"	"text"
"NovaRazaoSocial3"	"text"
"NovaRazaoSocial"	"text"
"Eventos"	"text"
"SenhaGov"	"text"
"RespPai"	"text"
"NIRERegistro"	"text"
"NIRERegistroData"	"timestamp with time zone"
"NovaRazaoSocialFinal"	"text"
"IEOnline"	"text"
"IETipo"	"text"
"IEeProcNum"	"text"
"IEDataAltSolicitado"	"timestamp with time zone"
"SistemaExterno"	"text"
"NireData"	"timestamp with time zone"
"DadosSocios"	"text"
"QuantidadeSocios"	"text"
"DocContratos"	"bytea"
"RazaoSocialAntiga"	"text"
"SituacaoCadastral"	"text"
"DivisaoCapitalSocios"	"text"
"CapitalQuotaValor"	"text"
"CapitaQuotaTotal"	"text"
"CPFdoCONJUGE"	"text"
"NOMEdoCONJUGE"	"text"
"ResponsavelOrgaoRG"	"text"
"ResponsavelEstadoOrgaoRG"	"text"
"NumeroProcesso"	"text"
"ReciboProcesso"	"text"
"SEDE"	"text"
"PontoDeReferencia"	"text"
"TipoUnidadeProdutiva"	"text"
"FormaDeAtuacao"	"text"
"DadosComplEstabelecimento"	"text"
"DadosComplAtividade"	"text"
"DadosComplPavimentos"	"text"
"DadosComplPessoas"	"text"
"DadosComplSubsolo"	"text"
"DadosComplLiquido"	"text"
"DadosComplGLP"	"text"
"AjudaTipodeUnidade"	"text"
"DBEProtocolo"	"text"
"DBEData"	"timestamp with time zone"
"FederalProtocolo"	"text"
"SenhasDeAcesso"	"text"
"CapitalSocialAntigo"	"text"
"CapitalAntigoMudou"	"text"
"CNAEAtividadeNoLocal"	"text"
"CNAEAtvLocalPrincipal"	"text"
"CNAEAtvLocalSEcundarios"	"text"
"BombeiroAtvAdm"	"text"
"BombeiroAtvresidencia"	"text"
"CNAEdescricaoOficial"	"text"
"ObjetoDOEstabelecimento"	"text"
"SimplesEcac"	"text"
"AvisarEmpresa"	"boolean"
"AvisarEmpresaTexto"	"text"
"TemEnderecoAntigoEmp"	"text"
"EnderecoAntigoEmp"	"text"
"CodSistemaExterno"	"text"
-----

SELECT "ID_Laudos", "RazaoSocial", "CNPJ", "Endereco", "EndNum", "EndComp", "EndData", "EndQuadra", "EndZona", "EndCEP", "Telefone", "CNAE", "NaturezaDoPedido", "NaturezaDoPedidoOBS", "Requerente", "CPFRequerente", "EndRequerente", "FoneRequerente", "EmailRequerente", "CNPJRequerente", "RGRequerente", "Ramodeatividade", "Obs", area, "Resptecnico", "ResptecnicoNumero", "Lembrete", "EndBairro", "EndCidade", "EndEstado", "Bombeiros", "BombeirosSituacao", "BombeirosVenc", "Ambiental", "AmbientalSituacao", "AmbientalVenc", "Viabilidade", "ViabilidadeSituacao", "ViabilidadeVec", "Sanitario", "SanitarioSituacao", "SanitarioVenc", "Setran", "SetranSituacao", "SetranVenc", "BombeiroExigencia", "AmbientalExigencia", "ViabilidadeExigencia", "SanitarioExigencia", "SetranExigencia", "BombeiroDataProvisorio", "AmbientalDataProvisorio", "ViabilidadeDataProvisorio", "SanitarioDataProvisorio", "SetranDataProvisorio", "BombeiroNProcesso", "BombeiroDataPedProcesso", "Nlaudo", "Situacao", "DataCriado", "DataEntrada", "Pendencia", "ModeloSistema", "AvisarDia", "CadImob", "CMC", area2, "PontoRef", "Sanitariocontrole1", "Sanitariocontrole2", "Sanitariocontrole3", "Observacao", "ProtocoloTipo", "ProtocoloN", "ProtocoloAno", "ProtocoloSenha", "Historico", "BombeiroSituacao", "BombeiroProvisorioDATA", "AmbientalProvisorioDATA", "ViabilidadeProvisorioDATA", "SanitarioProvisorioDATA", "SetranProvisorioDATA", "OrgaoRGRequerente", "EstadoOrgaoRGRequerente", "NumeroProcesso", "ReciboProcesso", "Prioridade", "Matriz", "BombeiroDataMulta", "NlaudoSecundario", "CNAEPrimario", "Alvara"
FROM public."Laudos";

"ID_Laudos"	"smallint"
"RazaoSocial"	"text"
"CNPJ"	"character varying"
"Endereco"	"character varying"
"EndNum"	"character varying"
"EndComp"	"character varying"
"EndData"	"character varying"
"EndQuadra"	"character varying"
"EndZona"	"character varying"
"EndCEP"	"character varying"
"Telefone"	"character varying"
"CNAE"	"text"
"NaturezaDoPedido"	"text"
"NaturezaDoPedidoOBS"	"text"
"Requerente"	"text"
"CPFRequerente"	"character varying"
"EndRequerente"	"text"
"FoneRequerente"	"character varying"
"EmailRequerente"	"text"
"CNPJRequerente"	"character varying"
"RGRequerente"	"character varying"
"Ramodeatividade"	"text"
"Obs"	"text"
"area"	"character varying"
"Resptecnico"	"text"
"ResptecnicoNumero"	"character varying"
"Lembrete"	"character varying"
"EndBairro"	"character varying"
"EndCidade"	"character varying"
"EndEstado"	"character varying"
"Bombeiros"	"character varying"
"BombeirosSituacao"	"character varying"
"BombeirosVenc"	"character varying"
"Ambiental"	"character varying"
"AmbientalSituacao"	"character varying"
"AmbientalVenc"	"character varying"
"Viabilidade"	"character varying"
"ViabilidadeSituacao"	"character varying"
"ViabilidadeVec"	"character varying"
"Sanitario"	"character varying"
"SanitarioSituacao"	"character varying"
"SanitarioVenc"	"character varying"
"Setran"	"character varying"
"SetranSituacao"	"character varying"
"SetranVenc"	"character varying"
"BombeiroExigencia"	"text"
"AmbientalExigencia"	"text"
"ViabilidadeExigencia"	"text"
"SanitarioExigencia"	"text"
"SetranExigencia"	"text"
"BombeiroDataProvisorio"	"character varying"
"AmbientalDataProvisorio"	"character varying"
"ViabilidadeDataProvisorio"	"character varying"
"SanitarioDataProvisorio"	"character varying"
"SetranDataProvisorio"	"character varying"
"BombeiroNProcesso"	"character varying"
"BombeiroDataPedProcesso"	"character varying"
"Nlaudo"	"character varying"
"Situacao"	"character varying"
"DataCriado"	"character varying"
"DataEntrada"	"character varying"
"Pendencia"	"character varying"
"ModeloSistema"	"character varying"
"AvisarDia"	"character varying"
"CadImob"	"character varying"
"CMC"	"character varying"
"area2"	"text"
"PontoRef"	"character varying"
"Sanitariocontrole1"	"character varying"
"Sanitariocontrole2"	"character varying"
"Sanitariocontrole3"	"character varying"
"Observacao"	"text"
"ProtocoloTipo"	"text"
"ProtocoloN"	"text"
"ProtocoloAno"	"text"
"ProtocoloSenha"	"text"
"Historico"	"text"
"BombeiroSituacao"	"text"
"BombeiroProvisorioDATA"	"timestamp without time zone"
"AmbientalProvisorioDATA"	"timestamp without time zone"
"ViabilidadeProvisorioDATA"	"timestamp without time zone"
"SanitarioProvisorioDATA"	"timestamp without time zone"
"SetranProvisorioDATA"	"timestamp without time zone"
"OrgaoRGRequerente"	"text"
"EstadoOrgaoRGRequerente"	"text"
"NumeroProcesso"	"text"
"ReciboProcesso"	"text"
"Prioridade"	"text"
"Matriz"	"text"
"BombeiroDataMulta"	"text"
"NlaudoSecundario"	"character varying"
"CNAEPrimario"	"text"
"Alvara"	"text"
------

SELECT "ID_Socios", "CPF", "NomeCompleto", "NomeMae", "NomePai", "DatadeNasc", "RG", "OrgaoRG", "EstadoRG", "TituloDeEleitor", "SenhaGOV", "CNH", "CNHExpedicao", "CNHDataExp", "Civil", "CEP", "RUA", "Num", "Bairro", "Complemento", "Cidade", "Estado", "País", "Telefone1", "Telefone2", "eMail", "Genero", "CPFdoCONJUGE", "NOMEdoCONJUGE", "Profissão", "OutrosDados", "MenorIdade", "RegistroOrgao", "RegistroEstado", "RegistroNumero", "RegistroData"
FROM public."Socios";
"ID_Socios"	"integer"
"CPF"	"text"
"NomeCompleto"	"text"
"NomeMae"	"text"
"NomePai"	"text"
"DatadeNasc"	"text"
"RG"	"text"
"OrgaoRG"	"text"
"EstadoRG"	"text"
"TituloDeEleitor"	"text"
"SenhaGOV"	"text"
"CNH"	"text"
"CNHExpedicao"	"text"
"CNHDataExp"	"text"
"Civil"	"text"
"CEP"	"text"
"RUA"	"text"
"Num"	"text"
"Bairro"	"text"
"Complemento"	"text"
"Cidade"	"text"
"Estado"	"text"
"País"	"text"
"Telefone1"	"text"
"Telefone2"	"text"
"eMail"	"text"
"Genero"	"text"
"CPFdoCONJUGE"	"text"
"NOMEdoCONJUGE"	"text"
"Profissão"	"text"
"OutrosDados"	"text"
"MenorIdade"	"text"
"RegistroOrgao"	"text"
"RegistroEstado"	"text"
"RegistroNumero"	"text"
"RegistroData"	"text"
------

SELECT "RazaoSocial", "CNPJ", "FormaDeEnvio", "Responsavel", "Whatsapp", "Email", "Socio", "CPF", "SenhaGov", "DataCriacao", "DataLembrete", "DataFinalizado", "MEI", "InssAntigo", "InssNovo", "InssProcur", "DataSolicMEI", "DataEnviaMEI", "DataFinalMEI", "MotivoMEI", "ProtMEI", "TotalParcMEI", "EnviaParcMEI", "DataSolicAntigo", "DataEnviaAntigo", "DataFinalAntigo", "MotivoAntigo", "ProtAntigo", "TotalParcAntigo", "EnviaParcAntigo", "DataSolicNovo", "DataEnvioNovo", "DataFinalNovo", "MotivoNovo", "ProtNovo", "TotalParcNovo", "EnviaParcNovo", "DataSolicProc", "DataEnviaProc", "DataFinalProc", "MotivoProc", "Protproc", "TotalParcProc", "EnviaParcProc", "ID_Parcel", "ParcelEnvMEI", "ParcelEnvINSSAnt", "ParcelEnvINSSNov", "ParcelEnvINSSProc", "FinalizadoEmpresa", "FinalizadoMEI", "FinalizadoINSSAnt", "FinalizadoINSSNov", "FinalizadoINSSProc", "FinalizadoMesGeral", "Geral", "ParaFazer", "AtrasoParcelaMEI", "AtrasoParcelaINSSAntigo", "AtrasoParcelaINSSNovo", "AtrasoParcelaINSSProcu"
FROM public."Parcelamentos";
"RazaoSocial"	"text"
"CNPJ"	"text"
"FormaDeEnvio"	"text"
"Responsavel"	"text"
"Whatsapp"	"text"
"Email"	"text"
"Socio"	"text"
"CPF"	"text"
"SenhaGov"	"text"
"DataCriacao"	"text"
"DataLembrete"	"text"
"DataFinalizado"	"text"
"MEI"	"text"
"InssAntigo"	"text"
"InssNovo"	"text"
"InssProcur"	"text"
"DataSolicMEI"	"text"
"DataEnviaMEI"	"text"
"DataFinalMEI"	"text"
"MotivoMEI"	"text"
"ProtMEI"	"text"
"TotalParcMEI"	"text"
"EnviaParcMEI"	"text"
"DataSolicAntigo"	"text"
"DataEnviaAntigo"	"text"
"DataFinalAntigo"	"text"
"MotivoAntigo"	"text"
"ProtAntigo"	"text"
"TotalParcAntigo"	"text"
"EnviaParcAntigo"	"text"
"DataSolicNovo"	"text"
"DataEnvioNovo"	"text"
"DataFinalNovo"	"text"
"MotivoNovo"	"text"
"ProtNovo"	"text"
"TotalParcNovo"	"text"
"EnviaParcNovo"	"text"
"DataSolicProc"	"text"
"DataEnviaProc"	"text"
"DataFinalProc"	"text"
"MotivoProc"	"text"
"Protproc"	"text"
"TotalParcProc"	"text"
"EnviaParcProc"	"text"
"ID_Parcel"	"integer"
"ParcelEnvMEI"	"text"
"ParcelEnvINSSAnt"	"text"
"ParcelEnvINSSNov"	"text"
"ParcelEnvINSSProc"	"text"
"FinalizadoEmpresa"	"text"
"FinalizadoMEI"	"text"
"FinalizadoINSSAnt"	"text"
"FinalizadoINSSNov"	"text"
"FinalizadoINSSProc"	"text"
"FinalizadoMesGeral"	"text"
"Geral"	"text"
"ParaFazer"	"text"
"AtrasoParcelaMEI"	"text"
"AtrasoParcelaINSSAntigo"	"text"
"AtrasoParcelaINSSNovo"	"text"
"AtrasoParcelaINSSProcu"	"text"
    
select "id_login", "usuario", "senha", "nomecompleto", "tema", "datanascimento"
	from public."Login";

    "id_login"	"smallint"
"usuario"	"character varying"
"senha"	"character varying"
"nomecompleto"	"character varying"
"tema"	"character varying"
"datanascimento"	"character varying"
"email"	"character varying"
---------------
--------------
---------------